F 0, 0, 0
C 255, 44, 44

NO ./img/blue_planks.xpm
SO ./img/yellow_planks.xpm
WE ./img/red_planks.xpm
EA ./img/green_planks.xpm


        1111111111111111111111111
        1000000000110000000100001
        1000000000100000000000001
        1001000000D00000000010001
11111111111000001110000000N00001
11111111111111111111111DDDDDDD111
1000000000000000000001000000000001
111101111111110111000D0010100100011111111
11000000110101011100010000001000000000001
1DDDDDDDDDDDDDDDDDDDD1DDDDDDDDDDDDDDDDDD1
100000000000000011010100100000000000001111
110000011101010111110111100011111100000001
11110111  1110101   1011110100011111111111
10000001111000000111100001000000000000001
1000000000000100000000000D000000111111111
111111111111111111111111111111111