F 100,100,100
C 158,90,098

NO ./img/blue_planks.xpm
SO ./img/yellow_planks.xpm
EA ./img/green_planks.xpm
WE ./img/red_planks.xpm


        1111111111111111111111111
        1000000000110000000000001
        1011000001110010000000001
        1001000000000000000010001
111111111011000001110000000N00001
1000000000110000011101111111111111
10000000000000000000000000001
10000000000001011101010010001
11111111111111111111111111111
10000000000000001100000010001
10000000000000001101010010001
1100000111010101111101111000111
11110111 1110101 101111010001
11111111 1111111 111111111111
