F 100,100,100
C 158,90,098

NO ./img/blue_planks.xpm
SO ./img/yellow_planks.xpm
WE ./img/red_planks.xpm
EA ./img/green_planks.xpm


        1111111111111111111111111
        1000000000110000000100001
        1011000001110010000000001
        1001000000000000000010001
11111111011000001110000000N00001
1000000000110000011101111111111111
1111011111111101110000000000010001
11110111111111011100000010100100011111111
11000000110101011100000000001000000000001
100000000000000011000000000100000000000001
100000000000000011010100100000000000001111
110000011101010111110111100011111100000001
11110111  1110101   1011110100011111111111
10000001111000000111100000000000000000001
10000000000001000000000000000000111111111
111111111111111111111111111111111